#####################
#.G.................#
#.###.#.#####.#.###.#
#.....#...#...#.....#
#X....##.....##....X#
#.....#       #.....#
#.##             ##.#
#.##.## ###--### ##.#
#...................#
#.##.## ##    ## ##.#
    .   #  GG  #    .      
### .#  #  GG  #  ###
  # .#  ########  #
  # .#     P      #     
  #....... ##. ..X#
  # .#####.##.### #
  #.............. #
###..##...######. ###
#....##........X....#
#.#####....##.#######
#.................G.#
#####################